2 2 2 2 2 2 2 2 2 2 2 2 2 2 2 2 2 2 2 94 95 96 1 32 1 1 21 16 16 16 16 16 16 16 16 16 16 16 22 1 1 1 79 7 2 2 2 6 94 95 96 1 1 23 27 16 16 16 16 16 16 16 16 16 16 16 16 28 20 1 1 1 1 1 1 1 1 1 1 1 1 1 1 1 1 1 1 38 1 1 1 2 2 2 2 2 2 2 2 2 
2 2 2 2 2 2 2 2 2 2 2 2 2 2 2 2 2 2 2 91 92 93 1 1 46 47 21 16 16 16 16 16 16 16 16 16 16 16 22 1 1 38 37 7 2 2 2 6 91 92 93 1 1 1 23 27 16 16 16 16 16 16 16 16 16 16 16 16 22 1 1 78 1 1 1 30 1 1 1 1 1 33 39 1 1 1 1 1 1 1 1 1 2 2 2 2 2 2 2 2 
2 2 2 2 2 2 2 2 2 2 2 2 2 2 2 2 2 2 2 86 87 90 39 1 44 45 21 16 16 16 16 16 16 16 16 16 16 16 22 1 1 84 85 7 2 2 2 6 86 87 90 1 1 1 1 21 16 16 16 16 16 16 16 16 16 16 16 16 22 1 1 1 1 1 1 1 1 1 1 97 88 89 1 1 1 1 1 1 1 1 1 34 1 2 2 2 2 2 2 2 
2 2 2 2 2 2 2 2 2 2 2 2 2 2 2 2 2 2 84 85 46 47 1 1 1 78 23 27 16 16 16 16 16 16 16 16 16 16 22 1 1 82 83 7 2 2 2 6 1 78 1 1 1 1 1 21 16 16 16 16 16 16 16 16 16 16 16 16 22 0 1 1 1 1 78 1 1 1 1 94 95 96 1 34 1 1 1 38 1 1 1 1 1 1 2 2 2 2 2 2 
2 2 2 2 2 2 2 2 2 2 2 2 2 2 2 2 2 2 82 83 44 45 1 1 97 88 89 21 16 16 16 16 16 16 16 16 16 16 22 1 1 80 81 7 2 2 2 6 34 1 1 1 1 1 1 21 16 16 16 16 16 16 16 16 16 16 16 16 22 1 38 1 1 1 1 1 1 30 1 91 92 93 1 1 1 1 1 1 1 34 1 1 1 1 2 2 2 2 2 2 
2 2 2 2 2 2 2 2 2 2 2 2 2 2 2 2 2 1 80 81 1 1 42 37 94 95 96 21 16 16 16 16 16 16 16 16 16 16 22 1 1 1 78 7 2 2 2 6 46 47 1 1 1 1 32 21 16 16 16 16 16 16 16 16 16 16 16 16 22 1 1 1 1 1 1 1 1 1 1 86 87 90 1 1 46 47 1 1 1 1 1 1 1 1 79 2 2 2 2 2 
2 2 2 2 2 2 2 2 2 2 2 2 2 2 2 2 2 1 36 1 1 1 32 1 91 92 93 21 16 16 16 16 16 16 16 16 16 26 25 1 97 88 89 7 2 2 2 6 44 45 1 1 32 1 1 21 16 16 16 16 16 16 16 16 16 16 16 16 22 1 1 1 1 1 1 30 1 1 1 1 1 1 1 1 44 45 1 1 1 1 97 88 89 1 1 2 2 2 2 2 
2 2 2 2 2 2 2 2 2 2 2 2 2 2 2 32 1 1 97 88 89 1 1 1 86 87 90 21 16 16 16 16 16 16 16 16 26 25 1 1 94 95 96 7 2 2 2 6 97 88 89 1 1 1 1 21 16 16 16 16 16 16 16 16 16 16 16 16 22 1 1 1 1 1 1 1 1 1 1 1 1 1 1 1 1 1 1 1 37 1 94 95 96 78 1 2 2 97 88 89 
2 2 2 2 2 2 2 2 2 2 2 2 2 1 1 1 38 1 94 95 96 1 38 1 1 1 1 21 16 16 16 16 16 16 16 26 25 1 1 1 91 92 93 7 2 2 2 6 94 95 96 1 1 1 1 21 16 16 16 16 16 16 16 16 16 16 16 16 22 1 1 1 1 34 1 1 1 38 1 1 1 1 1 1 1 1 1 1 1 1 91 92 93 1 2 2 2 94 95 96 
2 2 2 2 2 2 2 2 2 2 2 2 2 1 97 88 89 1 91 92 93 1 1 1 1 39 1 21 16 16 16 16 16 16 16 22 1 1 1 1 86 87 90 7 2 2 2 6 91 92 93 1 1 1 1 21 16 16 16 16 16 16 16 16 16 16 16 16 22 97 88 89 1 1 1 1 1 1 1 1 1 78 1 1 1 1 1 38 1 1 86 87 90 2 2 2 1 91 92 93 
2 2 2 2 2 2 2 2 2 2 2 2 1 39 94 95 96 1 86 87 90 1 1 32 1 1 1 21 16 16 16 16 16 16 16 22 1 1 1 1 1 97 89 7 2 2 2 6 86 87 90 1 32 1 1 21 16 16 16 16 16 16 16 16 16 16 16 16 22 94 95 96 1 1 1 1 1 1 1 1 1 1 1 1 1 1 1 1 1 78 38 1 2 2 2 31 38 86 87 90 
2 2 2 2 2 2 2 2 2 2 42 1 30 30 91 92 93 42 1 1 1 1 1 1 97 88 89 21 16 16 16 16 16 16 16 22 1 42 1 39 1 94 96 7 2 2 2 6 84 85 1 1 1 1 1 21 16 16 16 16 16 16 16 16 16 16 16 16 22 91 92 93 1 1 1 1 1 1 1 31 1 1 1 1 97 88 89 101 100 39 1 2 2 2 1 97 88 89 1 1 
2 2 2 2 2 2 2 2 2 30 97 88 89 1 86 87 90 1 1 1 1 78 1 1 94 95 96 21 16 16 16 16 16 16 16 22 1 1 1 1 1 91 93 7 2 2 2 6 82 83 1 41 1 1 1 21 16 16 16 16 16 16 16 16 16 16 16 16 22 86 87 90 1 1 1 1 1 1 1 1 1 1 1 1 94 95 96 99 98 2 2 2 2 1 1 94 95 96 1 38 
2 2 2 2 2 2 97 88 89 1 94 95 96 1 1 32 1 1 1 32 1 1 1 1 91 92 93 23 27 16 16 16 16 16 16 22 1 1 1 1 1 86 90 7 2 2 2 6 80 81 1 1 1 1 1 21 16 16 16 16 16 16 16 16 16 16 16 16 22 1 1 1 1 1 1 1 37 1 1 1 1 1 1 1 91 92 93 1 2 2 2 2 1 84 85 91 92 93 1 1 
78 2 2 2 78 32 94 95 96 1 91 92 93 1 1 1 1 1 101 100 97 88 89 1 86 87 90 1 23 27 16 16 16 16 26 25 1 1 1 1 1 84 85 7 2 2 2 6 97 88 89 1 1 1 1 23 24 24 27 16 16 16 16 16 16 16 16 16 22 1 1 1 1 1 1 1 1 1 1 1 1 1 1 1 86 87 90 2 2 2 38 1 1 82 83 86 87 90 1 1 
1 2 2 2 79 1 91 92 93 78 86 87 90 1 1 35 1 1 99 98 94 95 96 1 1 1 1 1 1 23 27 16 16 16 22 1 1 1 1 1 1 82 83 7 2 2 2 6 94 95 96 1 1 1 1 1 1 1 23 27 16 16 16 16 16 16 16 26 25 1 1 1 1 97 88 89 78 1 39 1 1 1 1 1 1 1 2 2 2 1 1 1 1 80 81 1 1 1 38 35 
1 2 2 2 39 1 86 87 90 1 1 1 1 1 1 1 1 78 1 1 91 92 93 1 1 1 1 1 1 1 21 16 16 16 22 1 1 1 38 1 1 80 81 7 2 2 2 6 91 92 93 1 1 32 1 42 1 1 1 23 16 16 16 16 16 16 16 25 1 1 1 1 1 94 95 96 1 1 1 1 1 97 88 89 46 47 2 2 1 1 97 88 89 1 1 1 1 38 1 1 
43 2 2 2 1 1 1 32 97 88 89 1 1 46 47 1 1 1 1 1 86 87 90 1 1 1 1 1 1 1 21 16 16 16 22 1 1 1 1 1 97 88 89 7 2 2 2 6 86 87 90 1 1 1 1 1 1 1 1 1 23 27 16 16 16 26 25 1 1 1 1 39 1 91 92 93 1 1 1 1 1 94 95 96 44 45 2 2 101 100 94 95 96 1 78 1 78 1 34 31 
1 2 2 2 1 1 42 1 94 95 96 1 1 44 45 1 1 1 97 88 89 1 1 1 1 1 78 1 1 1 23 27 16 16 22 1 1 1 1 1 94 95 96 7 2 2 2 6 46 47 1 1 1 1 1 1 1 1 1 1 1 23 24 27 26 25 1 1 1 1 1 1 1 86 87 90 1 1 97 88 89 91 92 93 78 1 2 2 99 98 91 92 93 1 1 1 1 1 1 1 
38 2 2 2 1 97 88 89 91 92 93 1 1 1 1 97 89 1 94 95 96 1 1 39 41 1 1 1 1 1 1 21 16 16 28 20 1 1 1 1 91 92 93 7 2 2 2 6 44 45 1 1 1 1 1 1 1 97 88 89 1 1 1 23 25 1 78 1 1 32 1 1 1 1 1 1 84 85 94 95 96 86 87 90 2 2 2 2 38 1 86 87 90 1 1 46 47 1 97 88 
1 2 2 2 1 94 95 96 86 87 90 1 1 1 1 94 96 1 91 92 93 1 1 1 1 1 1 1 1 38 1 23 24 24 24 25 1 1 78 1 86 87 90 7 2 2 2 6 97 88 89 1 1 1 101 100 1 94 95 96 1 1 1 1 1 1 1 1 1 1 1 1 1 1 1 1 82 83 91 92 93 2 2 2 2 2 2 1 1 1 1 1 1 38 1 44 45 1 94 95 
85 2 2 2 1 91 92 93 1 1 1 1 1 1 1 91 93 1 86 87 90 1 1 1 1 97 88 89 1 1 1 1 1 33 31 1 1 1 1 1 1 1 78 7 2 2 2 6 94 95 96 1 1 1 99 98 1 91 92 93 1 78 1 1 1 30 1 38 1 1 1 1 97 88 89 78 80 81 86 87 90 2 2 2 2 2 1 1 97 88 89 1 32 78 1 1 1 1 91 92 
83 2 2 2 1 86 87 90 1 1 38 84 85 1 1 86 90 1 78 1 1 1 1 1 1 94 95 96 1 1 1 1 1 30 42 1 1 1 1 1 97 88 89 7 2 2 2 6 91 92 93 1 32 1 1 1 1 86 87 90 1 1 1 1 1 1 1 1 78 1 1 1 94 95 96 1 101 100 1 2 2 2 2 1 1 101 100 1 94 95 96 1 1 1 1 97 88 89 86 87 
81 2 2 2 32 1 1 1 1 1 1 82 83 1 1 1 1 1 1 84 85 1 1 1 1 91 92 93 1 1 1 1 78 1 1 1 1 1 1 1 94 95 96 7 2 2 2 6 86 87 90 97 88 89 1 1 1 1 1 1 1 1 1 101 100 32 1 1 1 1 1 1 91 92 93 1 99 98 2 2 2 2 1 84 85 99 98 1 91 92 93 1 1 84 85 94 95 96 1 2 
1 2 2 2 1 39 1 1 97 88 89 80 81 1 97 88 89 1 1 82 83 1 1 1 1 86 87 90 1 1 38 1 1 1 1 1 38 1 1 1 91 92 93 7 2 2 2 6 101 100 1 94 95 96 1 1 1 1 1 1 1 32 1 99 98 1 1 97 88 89 97 89 86 87 90 78 2 2 2 2 38 1 1 82 83 1 1 1 86 87 90 1 1 82 83 91 92 93 1 2 
38 2 2 2 2 1 1 1 94 95 96 1 0 0 94 95 96 1 37 80 81 1 1 97 95 89 1 1 1 1 1 1 1 1 1 1 1 1 1 1 86 87 90 7 2 2 2 6 99 98 1 91 92 93 1 38 84 85 1 1 1 1 1 1 1 1 1 94 95 96 94 96 1 1 2 2 2 2 2 1 1 46 47 80 81 1 31 84 85 1 101 100 1 80 81 86 87 90 2 2 
1 1 2 2 2 2 1 1 91 92 93 1 1 1 91 92 93 1 1 1 1 1 1 94 95 96 1 1 39 1 1 1 1 1 1 1 1 1 1 84 85 101 100 1 2 2 2 31 32 33 1 86 87 90 1 1 82 83 1 1 1 1 1 1 46 47 1 91 92 93 91 93 1 2 2 2 2 2 1 32 1 44 45 46 47 1 1 82 83 30 99 98 1 1 1 1 1 2 2 2 
1 32 1 2 2 2 33 30 86 87 90 1 38 1 86 87 90 1 97 88 89 1 1 91 92 93 1 1 1 1 1 39 1 38 1 1 1 1 1 82 83 99 98 2 2 2 2 2 2 2 78 1 1 46 47 1 80 81 1 1 1 46 47 1 44 45 78 86 87 90 86 90 2 2 2 1 1 97 88 89 78 84 85 44 45 1 1 80 81 1 35 97 88 89 78 2 2 2 2 2 
88 89 1 2 2 2 31 1 1 1 1 97 88 89 1 1 1 1 94 95 96 1 1 86 87 90 1 1 1 1 1 1 1 1 97 88 89 46 47 80 81 2 2 2 2 2 2 2 2 2 2 2 2 44 45 1 33 1 97 88 89 44 45 34 1 97 88 89 101 100 78 2 2 2 46 47 1 94 95 96 1 82 83 46 47 35 1 1 1 1 1 94 95 96 2 2 2 2 2 2 
95 96 1 2 2 2 78 1 38 1 1 94 95 96 1 39 1 1 91 92 93 1 1 1 1 1 1 1 1 34 1 1 1 1 94 95 96 44 45 2 2 2 2 2 2 31 79 2 2 2 2 2 2 2 2 31 37 1 94 95 96 1 30 78 1 94 95 96 99 98 2 2 2 1 44 45 39 91 92 93 1 80 81 44 45 1 1 97 88 89 1 91 92 93 2 2 2 2 2 2 
92 93 1 2 2 2 2 2 1 1 1 91 92 93 31 1 1 1 86 87 90 1 1 1 1 1 1 1 1 1 1 1 101 100 91 92 93 1 2 2 2 2 2 78 1 1 97 88 89 2 2 2 2 2 2 2 2 36 91 92 93 1 84 85 1 91 92 93 1 2 2 2 1 1 32 1 1 86 87 90 78 39 97 88 89 30 1 94 95 96 1 86 87 90 2 2 2 2 2 2 
87 90 33 2 2 2 2 2 2 2 2 86 87 90 1 1 97 88 89 1 38 46 47 38 1 97 88 89 1 1 1 34 99 98 86 87 90 2 2 2 2 2 1 97 88 89 94 95 96 1 31 2 2 2 2 2 2 2 86 87 90 36 82 83 1 86 87 90 1 2 2 2 33 34 1 84 85 1 38 39 84 85 94 95 96 43 1 91 92 93 1 1 2 2 2 2 2 2 2 2 
1 1 35 1 2 2 2 2 2 2 2 2 2 1 1 30 94 95 96 1 38 44 45 38 1 94 95 96 1 1 1 1 78 2 2 2 2 2 2 2 2 1 1 94 95 96 91 92 93 1 84 85 1 1 2 2 2 2 2 2 2 2 80 81 78 38 1 1 30 2 2 1 84 85 1 82 83 97 88 89 82 83 91 92 93 84 85 86 87 90 34 2 2 2 2 2 2 2 2 2 
78 1 1 32 1 30 1 84 85 2 2 2 2 2 78 1 91 92 93 1 1 32 32 1 1 91 92 93 34 1 1 1 2 2 2 2 2 2 2 2 2 43 1 91 92 93 86 87 90 1 82 83 97 88 89 39 2 2 2 2 2 2 2 2 2 2 78 1 2 2 2 78 82 83 78 80 81 94 95 96 80 81 86 87 90 82 83 1 1 31 1 2 2 2 2 2 2 2 2 2 
84 85 1 1 1 1 32 82 83 1 2 2 2 2 2 2 86 87 90 78 42 79 79 41 78 86 87 90 1 2 2 2 2 2 2 2 2 46 47 1 84 85 30 86 87 90 1 1 33 1 80 81 94 95 96 1 1 1 36 2 2 2 2 2 2 2 2 2 2 2 2 1 80 81 33 1 1 91 92 93 1 101 100 1 1 80 81 36 1 2 2 2 2 2 2 2 2 2 2 2 
82 83 31 97 88 89 1 80 81 1 39 2 2 2 2 2 2 2 2 2 2 2 2 2 2 2 2 2 2 2 2 2 2 2 2 1 1 44 45 1 82 83 1 1 101 100 1 46 47 1 1 33 91 92 93 1 97 88 89 1 1 30 1 101 100 1 2 2 2 2 2 2 2 2 1 1 31 86 87 90 1 99 98 1 2 2 2 2 2 2 2 2 2 2 2 2 2 2 2 2 
80 81 1 94 95 96 1 1 1 1 1 97 88 89 1 32 2 2 2 2 2 2 2 2 2 2 2 2 2 2 2 78 1 1 1 97 88 89 1 1 80 81 1 32 99 98 33 44 45 1 1 1 86 87 90 31 94 95 96 40 46 47 1 99 98 1 78 2 2 2 2 2 2 2 2 2 2 2 2 2 2 2 2 2 2 2 2 2 2 2 2 2 2 2 2 2 2 2 2 2 
1 1 1 91 92 93 1 97 88 89 32 94 95 96 1 1 1 84 85 2 2 2 2 2 2 2 43 1 1 1 1 97 88 89 1 94 95 96 1 1 1 84 85 1 97 88 89 1 1 101 100 84 85 31 1 1 91 92 93 1 44 45 1 1 1 1 2 2 2 46 47 78 2 2 2 2 2 2 2 2 2 2 2 2 2 2 97 88 89 101 100 2 2 2 2 2 2 2 2 2 
1 1 1 86 87 90 1 94 95 96 1 91 92 93 97 88 89 82 83 2 2 2 2 2 2 1 31 46 47 33 1 94 95 96 1 91 92 93 1 78 1 82 83 1 94 95 96 1 1 99 98 82 83 1 1 31 86 87 90 1 1 1 31 34 1 2 2 2 2 44 45 84 85 97 88 89 101 100 46 47 1 1 97 88 89 1 94 95 96 99 98 2 2 2 2 2 2 2 2 2 
97 88 89 1 1 78 1 91 92 93 1 86 87 90 94 95 96 80 81 1 2 2 2 2 31 1 1 44 45 1 1 91 92 93 1 86 87 90 97 88 89 80 81 1 91 92 93 97 88 89 1 80 81 1 1 40 1 1 1 1 1 84 85 1 2 2 2 2 2 1 1 82 83 94 95 96 99 98 44 45 34 1 94 95 96 1 91 92 93 1 30 1 2 2 2 2 2 2 2 2 
94 95 96 1 1 1 36 86 87 90 1 1 1 1 91 92 93 1 1 1 2 2 2 2 1 97 88 89 1 1 34 86 87 90 1 1 1 1 94 95 96 1 38 1 86 87 90 94 95 96 1 1 1 40 1 1 97 88 89 78 1 82 83 2 2 2 2 97 88 89 36 80 81 91 92 93 32 101 100 1 1 32 91 92 93 1 86 87 90 97 88 89 2 2 2 2 2 2 2 2 
91 92 93 1 97 88 89 1 1 1 1 78 1 1 86 87 90 1 34 1 2 2 2 2 1 94 95 96 1 1 1 97 88 89 1 1 1 1 91 92 93 1 1 1 1 1 1 91 92 93 1 40 1 1 1 1 94 95 96 1 1 80 81 2 46 47 1 94 95 96 1 1 1 86 87 90 1 99 98 97 88 89 86 87 90 1 1 1 42 94 95 96 1 2 2 2 2 2 2 2 
86 87 90 1 94 95 96 1 1 78 1 31 30 1 1 1 1 1 1 39 2 2 2 2 1 91 92 93 1 34 1 94 95 96 1 1 1 1 86 87 90 1 1 1 1 1 1 86 87 90 1 40 97 88 89 40 91 92 93 1 1 1 2 2 44 45 32 91 92 93 1 1 46 47 1 97 88 89 1 94 95 96 1 1 1 1 1 1 31 91 92 93 36 1 2 2 2 2 2 2 
1 1 101 100 91 92 93 1 1 1 1 1 1 84 85 1 97 88 89 1 2 2 2 2 78 86 87 90 84 85 78 91 92 93 1 1 31 1 1 38 1 1 1 1 1 1 37 1 34 1 1 1 94 95 96 1 86 87 90 1 1 2 2 2 2 2 2 86 87 90 34 1 44 45 37 94 95 96 1 91 92 93 1 1 1 1 1 1 1 86 87 90 84 85 46 47 2 2 2 2 
1 1 99 98 86 87 90 34 1 97 88 89 1 82 83 38 94 95 96 1 2 2 2 2 1 1 1 37 82 83 1 86 87 90 1 1 30 1 1 1 1 1 1 1 1 1 1 1 1 1 1 1 91 92 93 1 1 1 1 46 47 33 2 2 2 2 2 2 2 2 2 2 2 2 1 91 92 93 1 86 87 90 1 1 1 1 78 1 1 1 1 1 82 83 44 45 38 2 2 78 
1 1 1 1 1 1 1 1 78 94 95 96 1 80 81 1 91 92 93 1 2 2 2 2 97 88 89 1 80 81 97 88 89 1 1 1 34 1 1 1 97 88 89 1 34 1 1 1 1 79 1 1 86 87 90 84 85 1 33 44 45 30 1 2 2 2 2 2 2 2 2 2 2 2 2 86 87 90 84 85 46 47 1 1 1 42 41 1 1 1 1 1 80 81 1 1 97 88 89 1 
1 34 1 1 1 1 1 1 1 91 92 93 1 1 1 1 86 87 90 78 2 2 2 2 94 95 96 39 1 1 94 95 96 1 1 1 1 1 1 1 94 95 96 1 1 1 1 1 1 39 1 1 1 1 1 82 83 38 1 1 1 97 88 89 1 84 85 1 2 2 2 2 2 2 2 2 2 1 82 83 44 45 1 1 1 1 1 1 1 1 1 1 1 1 1 1 94 95 96 1 
1 1 1 1 1 1 1 1 1 86 87 90 1 31 1 31 1 1 1 79 2 2 2 2 91 92 93 1 1 34 91 92 93 1 1 1 1 1 1 1 91 92 93 1 1 1 1 1 1 1 1 1 1 1 30 80 81 1 1 30 1 94 95 96 1 82 83 97 88 89 1 46 47 2 2 2 2 2 80 81 1 97 88 89 1 1 46 47 1 1 1 1 1 1 1 1 91 92 93 1 
1 1 1 1 1 1 1 39 1 1 1 1 1 36 1 1 1 1 1 1 2 2 2 2 86 87 90 1 35 1 86 87 90 1 1 1 1 1 1 1 86 87 90 1 1 1 39 1 1 1 78 1 1 1 1 38 1 1 1 1 30 91 92 93 1 80 81 94 95 96 1 44 45 1 31 1 2 2 2 1 78 94 95 96 1 43 44 45 1 37 1 1 1 38 1 1 86 87 90 1 
1 1 38 1 1 1 1 1 1 1 1 1 1 1 1 1 1 1 32 1 2 2 2 2 1 97 88 89 39 1 46 47 1 1 1 1 1 38 1 1 1 1 1 101 100 1 1 1 1 1 1 1 1 1 1 1 1 1 30 1 1 86 87 90 1 1 1 91 92 93 1 38 1 97 88 89 1 2 2 1 1 91 92 93 1 1 1 1 1 1 1 1 1 1 1 1 1 1 1 1 
1 1 1 1 1 1 1 1 1 1 1 1 1 1 32 1 1 1 1 1 2 2 2 2 1 94 95 96 1 1 44 45 1 1 1 1 1 1 1 1 1 1 1 99 98 1 1 1 1 1 1 1 1 39 1 1 1 46 47 1 1 1 1 1 1 1 1 86 87 90 84 85 1 94 95 96 33 2 2 1 1 86 87 90 1 1 1 1 1 1 78 1 1 1 1 78 1 1 1 1 
1 1 1 1 1 1 1 1 1 1 1 35 1 1 1 1 1 1 1 1 2 2 2 2 1 91 92 93 46 47 38 1 1 97 88 89 1 1 1 1 1 1 1 1 1 1 1 1 1 1 1 1 1 1 1 1 1 44 45 1 1 1 1 1 78 1 1 101 100 1 82 83 1 91 92 93 1 2 2 1 101 100 1 1 1 97 88 89 1 1 1 1 1 1 1 1 1 1 1 1 
1 1 1 1 1 1 39 1 1 1 1 1 1 84 85 1 1 1 1 1 2 2 2 2 1 86 87 90 44 45 101 100 1 94 95 96 1 1 1 34 1 1 1 1 1 1 101 100 1 1 46 47 1 1 1 1 1 1 1 1 1 34 1 31 1 1 1 99 98 1 80 81 38 86 87 90 1 2 2 1 99 98 84 85 1 94 88 96 1 1 1 1 34 1 1 1 1 1 1 1 
39 1 1 1 1 1 1 1 1 97 88 89 1 82 83 1 1 97 88 89 78 2 2 2 2 1 1 101 100 1 99 98 1 91 92 93 1 1 1 1 78 1 1 1 1 1 99 98 1 1 44 45 1 1 1 1 38 1 1 1 1 1 1 1 1 97 88 89 31 1 1 1 1 1 1 1 1 2 2 1 42 1 82 83 1 91 92 93 46 47 1 1 1 1 1 1 1 1 38 1 
1 1 1 1 1 1 1 101 100 94 95 96 1 80 81 1 1 94 95 96 1 2 2 2 2 78 1 99 98 97 88 89 1 86 87 90 1 1 1 1 1 41 42 1 1 1 1 1 1 1 1 1 1 1 1 1 1 1 1 1 39 1 1 1 1 94 95 96 1 101 100 1 2 2 2 2 2 2 2 2 2 1 80 81 1 86 87 90 44 45 1 1 1 97 88 89 1 1 1 1 
1 1 1 32 1 1 1 99 98 91 92 93 1 1 46 47 1 91 92 93 1 2 2 2 2 2 46 47 1 94 95 96 1 1 1 1 1 1 1 1 1 1 1 1 1 1 1 1 1 1 1 1 1 1 1 78 97 88 89 1 1 97 88 89 1 91 92 93 1 99 98 2 2 2 2 2 2 2 2 2 2 2 2 2 2 2 1 1 1 32 1 1 1 94 95 96 1 1 1 1 
1 1 1 1 1 34 97 88 89 86 87 90 1 1 44 45 78 86 87 90 30 30 2 2 2 2 44 45 31 91 92 93 33 1 1 1 1 1 1 1 1 1 1 1 35 1 1 1 1 1 1 1 38 1 1 1 94 95 96 1 1 94 95 96 1 86 87 90 1 1 2 2 2 46 47 1 1 1 84 85 1 1 34 43 2 2 2 2 2 1 1 34 1 91 92 93 1 1 1 1 
1 32 1 1 1 1 94 95 96 1 1 1 1 1 1 1 1 1 31 1 97 88 89 2 2 2 2 2 31 86 87 90 33 97 88 89 1 1 97 88 89 1 1 1 1 1 1 1 1 1 1 1 1 1 1 1 91 92 93 33 31 91 92 93 1 1 1 1 2 2 2 2 1 44 45 1 34 34 82 83 39 101 100 46 47 2 2 2 2 2 2 2 2 86 87 90 97 88 89 1 
1 1 1 1 34 78 91 92 93 1 38 1 1 1 1 97 88 89 33 1 94 95 96 2 2 2 2 2 2 46 47 1 1 94 95 96 1 1 94 95 96 1 1 1 97 88 89 1 1 18 19 19 19 20 1 1 86 87 90 33 31 86 87 90 1 1 1 2 2 2 2 1 1 1 1 1 1 1 80 81 1 99 98 44 45 1 1 1 1 1 2 2 2 2 1 1 94 95 96 1 
1 1 1 97 88 89 86 87 90 1 97 88 89 1 1 94 95 96 1 1 91 92 93 1 1 2 2 2 2 44 45 1 1 91 92 93 1 1 91 92 93 1 1 78 94 95 96 101 100 21 16 16 16 22 1 1 1 1 84 85 46 47 1 1 1 38 2 2 2 18 19 19 19 19 19 19 19 19 19 19 19 19 19 19 19 19 19 19 19 19 19 20 1 2 2 2 91 92 93 1 
78 38 1 94 95 96 78 1 1 1 94 95 96 1 1 91 92 93 1 1 86 87 90 1 1 2 2 2 2 2 97 88 89 86 87 90 1 1 86 87 90 97 88 89 91 92 93 99 98 23 24 24 24 25 1 101 100 1 82 83 80 45 1 1 2 2 2 2 18 29 16 16 16 16 16 16 16 16 16 16 16 16 16 16 16 16 16 16 16 16 16 22 1 1 2 2 86 87 90 1 
97 88 89 91 92 93 1 1 1 1 91 92 93 1 1 86 87 90 1 1 1 1 97 88 89 30 78 2 2 2 94 95 96 1 1 1 1 101 100 1 1 94 95 96 86 87 90 32 65 66 67 68 69 71 1 99 98 1 80 81 1 1 1 2 2 2 2 1 21 16 16 16 16 16 16 16 16 16 16 16 16 16 16 16 16 16 16 16 16 16 16 28 20 1 1 2 2 78 101 100 
94 95 96 86 87 90 1 97 88 89 86 87 90 1 1 1 1 1 1 1 1 1 94 95 96 30 31 2 2 2 91 92 93 1 1 38 1 99 98 78 1 91 92 93 97 88 89 34 58 60 61 62 63 64 39 1 1 1 1 2 2 2 2 2 2 2 1 18 29 16 16 16 16 16 16 16 16 16 16 16 16 16 16 16 16 16 16 16 16 16 16 16 28 20 1 2 2 2 99 98 
91 92 93 46 47 1 1 94 95 96 1 1 1 1 1 1 1 1 1 1 1 1 91 92 93 1 1 2 2 2 86 87 90 1 1 1 1 1 1 1 1 86 87 90 94 95 96 1 52 53 54 55 56 57 84 85 32 1 2 2 2 2 2 2 2 18 19 29 16 16 16 16 16 16 16 16 16 16 16 16 16 16 16 16 16 16 16 16 16 16 16 16 16 28 20 1 2 2 2 1 
86 87 90 44 45 1 1 91 92 93 1 1 1 1 1 1 1 1 1 38 1 35 86 87 90 1 1 79 2 2 2 2 78 31 1 97 95 89 39 1 38 46 47 78 91 92 93 38 75 76 77 49 50 51 82 83 2 2 2 2 2 101 100 46 47 21 16 16 16 16 16 16 16 16 16 16 16 16 16 16 16 16 16 16 16 16 16 16 16 16 16 16 16 16 22 1 1 2 2 1 
20 1 1 1 1 1 1 86 87 90 1 1 1 1 1 38 1 1 1 1 1 1 1 1 32 1 1 1 2 2 2 2 31 31 1 94 95 96 101 100 1 44 45 1 86 87 90 79 48 59 70 72 73 74 80 81 2 2 2 2 1 99 98 44 45 21 16 16 16 16 16 16 16 16 16 16 16 16 16 16 16 16 16 16 16 16 16 16 16 16 16 16 16 16 22 1 38 2 2 1 
28 19 19 20 1 1 1 1 1 1 1 1 1 1 1 1 1 1 1 1 1 1 1 32 1 101 100 38 1 2 2 2 2 1 1 91 92 93 99 98 2 2 2 2 2 2 2 2 2 2 2 2 2 2 2 2 2 84 85 41 97 88 89 78 1 21 16 16 16 16 16 16 16 16 16 16 16 16 16 16 16 16 16 16 16 16 16 16 16 16 16 16 16 16 22 1 1 2 2 78 
16 16 16 22 1 1 1 1 1 1 1 1 1 1 78 1 1 1 1 1 1 1 1 1 1 99 98 1 1 1 39 2 2 2 1 86 87 90 2 2 2 2 2 2 2 2 2 2 2 2 2 2 2 2 1 38 78 82 83 1 94 95 96 84 85 21 16 16 16 16 16 16 16 16 16 16 16 16 16 16 16 16 16 16 16 16 16 16 16 16 16 16 16 16 22 1 1 2 2 43 
16 16 16 22 1 1 1 1 1 1 1 1 1 1 1 1 1 1 1 1 1 1 1 1 1 1 1 1 97 88 89 1 2 2 2 1 1 2 2 2 2 2 1 1 46 47 97 88 89 1 101 100 2 2 2 2 2 80 81 1 91 92 93 82 83 23 24 27 16 16 16 16 16 16 16 16 16 16 16 16 16 16 16 16 16 16 16 16 16 16 16 16 16 16 22 38 0 2 2 0 
16 16 16 28 20 38 1 1 1 1 36 1 1 1 1 1 1 1 1 1 38 1 1 1 1 1 1 1 94 95 96 101 100 2 2 2 2 2 2 2 1 1 1 32 44 45 94 95 96 1 99 98 2 2 2 2 2 2 2 2 86 87 90 80 81 1 1 23 24 24 24 24 24 27 16 16 16 16 16 16 16 16 16 16 16 16 16 16 16 16 16 16 16 16 22 1 2 2 2 0 
16 16 16 16 22 1 1 78 1 1 1 1 1 1 1 1 1 1 1 1 1 1 97 88 89 1 84 85 91 92 93 99 98 1 2 2 2 2 2 2 1 97 88 89 101 100 91 92 93 1 1 1 1 97 88 89 2 2 2 2 2 2 2 2 2 2 2 2 2 1 34 1 38 23 27 16 16 16 16 16 16 16 16 16 16 16 16 16 16 16 16 16 16 26 25 1 2 2 2 38 
16 16 16 16 22 1 1 1 1 1 1 1 1 39 1 1 1 1 1 1 1 1 94 95 96 1 82 83 86 87 90 97 88 89 1 2 2 2 2 43 1 94 95 96 99 98 86 87 90 1 1 1 78 94 95 96 1 101 100 2 2 2 2 2 2 2 2 2 2 2 2 2 2 2 23 27 16 16 16 16 16 16 16 16 16 16 16 16 16 16 16 16 26 25 1 2 2 2 0 0 
16 16 16 26 22 1 1 1 1 1 38 1 1 1 1 1 1 1 38 1 1 1 91 92 93 38 80 81 1 1 1 94 95 96 1 2 2 2 78 1 1 91 92 93 1 1 1 1 1 1 1 1 1 91 92 93 1 99 98 46 47 34 97 88 1 1 2 2 2 2 2 2 2 2 2 23 24 24 24 24 24 24 24 27 16 16 16 16 16 16 16 26 25 38 2 2 2 2 1 1 
16 16 26 25 38 1 1 1 1 1 1 1 1 1 1 1 1 1 1 1 1 1 86 87 90 78 97 88 89 1 1 91 92 93 1 2 2 2 31 31 1 86 87 90 1 1 1 1 1 1 1 1 1 86 87 90 1 1 1 44 45 78 94 95 96 39 2 2 2 2 2 2 2 2 2 2 2 2 2 1 43 1 1 23 16 16 16 16 16 16 16 22 1 1 2 2 2 97 88 89 
16 16 22 1 1 1 1 1 1 1 1 1 1 1 1 1 1 1 1 1 1 1 1 1 46 47 94 95 96 1 1 86 87 90 2 2 2 2 31 84 85 1 1 97 88 89 1 1 1 1 1 1 1 1 1 1 1 1 1 1 1 1 91 92 93 1 2 2 97 88 89 46 47 38 2 2 2 2 2 2 2 78 1 79 23 24 24 24 24 24 24 25 1 1 2 2 2 94 95 96 
16 16 22 1 1 1 1 1 1 1 34 1 1 1 1 38 1 1 1 1 1 97 88 89 44 45 91 92 93 1 1 1 1 1 2 2 2 2 31 82 83 1 43 94 95 96 1 34 1 1 1 1 1 1 1 1 1 1 1 1 1 1 86 87 90 1 2 2 94 95 96 44 45 1 78 42 2 2 2 2 2 2 2 2 1 1 78 1 46 47 101 100 41 42 2 2 38 91 92 93 
16 16 22 1 1 1 1 1 1 1 1 1 1 1 78 1 1 1 38 1 1 94 95 96 34 1 86 87 90 1 1 1 78 2 2 2 2 1 43 80 81 46 47 91 92 93 1 1 1 1 1 1 1 34 1 1 1 1 1 1 1 1 1 1 1 78 2 2 91 92 93 1 78 101 100 101 100 97 88 89 1 2 2 2 2 2 1 1 44 45 99 98 2 2 2 101 100 86 87 90 
16 16 22 1 1 1 1 34 1 1 1 1 1 1 1 38 1 1 1 1 1 91 92 93 1 1 1 1 101 100 1 2 2 2 2 2 97 88 89 1 1 44 45 86 87 90 1 1 1 41 1 1 1 1 1 1 1 1 1 1 1 1 1 97 88 89 2 2 86 87 90 1 1 99 98 99 98 94 95 96 1 1 1 2 2 2 2 2 38 1 2 2 2 2 1 99 98 1 1 1 
16 16 25 1 1 1 1 1 1 1 1 1 1 1 1 1 1 1 1 1 1 86 87 90 1 46 47 1 99 98 2 2 2 2 1 1 94 95 96 1 1 1 1 1 1 1 1 1 1 1 1 1 1 1 1 1 1 1 1 1 1 1 1 94 95 96 2 2 2 2 1 46 47 32 97 88 89 91 92 93 1 1 1 1 2 2 2 2 2 2 2 2 2 1 84 85 1 1 1 1 
26 25 1 1 1 1 1 1 1 1 1 1 1 1 1 1 1 1 1 1 1 1 1 1 1 44 45 1 1 2 2 2 2 97 88 89 91 92 93 1 1 97 88 89 34 1 1 1 1 1 1 78 1 1 1 1 1 1 1 35 1 1 1 91 92 93 1 2 2 2 2 44 45 1 94 95 96 86 87 90 1 1 78 1 1 1 1 2 2 2 2 1 1 1 82 83 1 1 1 1 
25 1 97 88 89 97 88 89 1 1 1 1 78 1 1 1 1 1 39 1 1 97 88 89 101 100 1 2 2 2 2 2 1 94 95 96 86 87 90 1 1 94 95 96 1 1 1 1 1 1 1 1 1 1 1 1 41 1 1 1 1 1 1 86 87 90 84 85 1 2 2 1 1 1 91 92 93 1 1 1 1 1 1 1 1 1 1 97 88 89 1 1 1 1 80 81 1 32 1 1 
78 1 94 95 96 94 95 96 1 1 1 1 1 1 1 1 1 1 1 1 1 94 95 96 99 98 2 2 2 2 2 1 34 91 92 93 1 35 1 1 1 91 92 93 39 1 1 1 1 1 1 1 1 1 1 1 1 1 1 1 1 1 1 1 1 1 82 83 1 2 2 2 2 1 86 87 90 84 85 1 1 1 1 1 1 39 1 94 95 96 1 1 38 1 1 1 1 1 1 1 
1 38 91 92 93 91 92 93 1 1 1 1 1 1 1 1 1 1 97 88 89 91 92 93 1 2 2 2 2 2 38 1 78 86 87 90 84 85 1 38 1 86 87 90 1 1 1 1 1 1 1 34 1 1 1 1 1 1 1 1 1 1 1 1 1 1 80 81 1 1 2 2 2 2 2 1 1 82 83 38 97 88 89 1 1 1 1 91 92 93 1 1 1 1 1 1 1 1 1 1 
1 1 86 87 90 86 87 90 46 47 97 88 89 1 1 97 88 89 94 95 96 86 87 90 2 2 2 2 1 1 97 88 89 1 38 1 82 83 1 1 1 1 34 1 1 1 1 1 1 1 1 1 1 1 1 1 1 1 1 78 1 1 1 1 1 1 1 1 1 1 1 1 2 2 2 2 1 80 81 78 94 95 96 1 1 1 1 86 87 90 1 1 1 1 42 1 1 1 32 1 
1 1 1 97 88 89 1 43 44 45 94 95 96 78 1 94 95 96 91 92 93 34 2 2 2 2 97 88 89 1 94 95 96 1 1 1 80 81 1 39 1 97 88 89 1 97 88 89 1 1 1 1 1 41 1 1 1 1 1 1 1 1 1 1 1 1 1 1 1 1 1 1 1 2 2 2 97 88 89 1 91 92 93 1 1 1 1 1 1 1 1 78 1 1 1 1 1 1 1 1 
97 88 89 94 95 96 97 88 89 1 91 92 93 46 47 91 92 93 86 87 90 2 2 2 2 39 94 95 96 1 91 92 93 1 1 1 1 1 1 1 1 94 95 96 1 94 95 96 1 1 1 1 1 1 1 1 1 1 1 1 1 41 1 35 1 1 1 1 1 1 1 1 1 1 2 2 94 95 96 1 86 87 90 1 1 1 1 32 1 1 1 1 1 1 1 1 1 1 39 1 
94 95 96 91 92 93 94 95 96 39 86 87 90 44 45 86 87 90 1 78 2 2 2 2 38 78 91 92 93 1 86 87 90 101 100 97 88 89 84 85 1 91 92 93 1 91 92 93 1 1 1 1 1 1 39 1 1 1 34 1 1 1 1 1 1 1 1 1 1 1 1 1 1 1 2 2 91 92 93 1 1 1 97 88 89 1 1 1 1 1 1 1 1 1 1 1 1 1 1 1 
91 92 93 86 87 90 91 92 93 78 2 2 2 2 2 2 2 2 2 2 2 2 2 2 2 2 86 87 90 1 1 1 1 99 98 94 95 96 82 83 78 86 87 90 78 86 87 90 1 1 1 1 1 1 1 1 1 1 1 1 1 1 1 1 1 34 97 88 89 1 1 1 1 1 2 2 86 87 90 46 47 78 94 95 96 1 1 1 1 1 1 1 39 1 1 38 0 1 1 39 
86 87 90 78 101 100 86 87 90 2 2 2 2 2 2 2 2 2 2 2 2 2 2 2 2 2 2 2 2 2 2 2 2 1 1 91 92 93 80 81 39 2 2 2 2 2 1 46 47 1 1 1 1 1 1 1 1 39 1 1 1 1 1 1 1 1 94 95 96 1 1 1 1 1 2 2 97 88 89 44 45 1 91 92 93 1 1 1 1 1 1 1 1 1 1 1 1 1 78 1 
2 78 46 47 99 98 2 2 2 2 2 2 31 37 1 46 47 97 88 89 38 1 1 78 2 2 2 2 2 2 2 2 2 2 1 86 87 90 34 2 2 2 2 2 2 2 2 44 45 1 1 1 97 88 89 1 1 1 1 1 97 88 89 1 101 100 91 92 93 97 88 89 84 85 2 2 94 95 96 78 101 100 86 87 90 1 1 1 1 39 1 1 1 1 1 1 1 1 32 1 
2 2 44 45 2 2 2 2 2 2 2 2 1 1 1 44 45 94 95 96 1 97 88 89 38 18 19 19 19 20 2 2 2 2 2 1 1 79 2 2 2 2 2 2 2 2 2 2 97 88 89 1 94 95 96 97 88 89 1 1 94 95 96 78 99 98 86 87 90 94 95 96 82 83 2 2 91 92 93 1 99 98 38 1 1 34 1 1 1 18 19 19 19 20 1 1 1 1 1 1 
2 2 2 2 2 2 2 2 101 100 46 47 38 30 1 1 1 91 92 93 78 94 95 96 78 21 16 16 16 28 20 2 2 2 2 2 2 2 2 2 2 2 2 2 2 2 2 2 94 95 96 1 91 92 93 94 95 96 1 1 91 92 93 46 47 1 1 46 47 91 92 93 80 81 2 2 86 87 90 1 41 42 1 39 18 19 19 19 19 29 16 16 16 28 19 19 19 20 1 1 
2 2 2 2 2 2 1 78 99 98 44 45 1 1 97 88 89 86 87 90 1 91 92 93 1 21 16 16 16 16 28 19 20 2 2 2 2 2 2 2 2 2 2 2 2 2 2 2 91 92 93 1 86 87 90 91 92 93 46 47 86 87 90 44 45 78 34 44 45 86 87 90 38 79 2 2 78 18 19 19 19 19 19 19 29 16 16 16 16 16 16 16 16 16 16 16 16 28 20 1 
2 2 2 2 2 78 1 1 1 46 47 97 88 89 94 95 96 1 1 1 1 86 87 90 18 29 16 16 16 16 16 16 28 19 19 19 20 1 2 2 2 2 2 2 2 2 2 2 86 87 90 78 1 1 1 86 87 90 44 45 18 19 19 19 19 20 2 2 2 2 2 2 2 2 2 2 2 21 16 16 16 16 16 16 16 16 16 16 16 16 16 16 16 16 16 16 16 16 28 19 
2 2 2 2 2 2 34 37 32 44 45 94 95 96 91 92 93 1 1 1 1 1 18 19 29 16 16 16 16 16 16 16 16 16 16 16 22 1 1 2 2 2 2 2 2 2 2 46 47 101 100 46 47 97 88 89 101 100 78 18 29 16 16 16 16 28 20 2 2 2 2 2 2 2 2 2 2 21 16 16 16 16 16 16 16 16 16 16 16 16 16 16 16 16 16 16 16 16 16 16 
2 2 2 2 2 2 2 38 35 34 1 91 92 93 86 87 90 1 1 1 18 19 29 16 16 16 16 16 16 16 16 16 16 16 16 16 22 97 88 89 1 2 2 2 2 2 1 44 45 99 98 44 45 94 95 96 99 98 18 29 16 16 16 16 16 16 28 20 2 2 2 2 2 2 2 2 2 21 16 16 16 16 16 16 16 16 16 16 16 16 16 16 16 16 16 16 16 16 16 16 
2 2 2 2 2 2 2 2 97 88 89 86 87 90 78 38 1 1 18 19 29 16 16 16 16 16 16 16 16 16 16 16 16 16 16 16 22 94 95 96 1 84 85 1 1 97 88 89 1 84 85 78 1 91 92 93 1 18 29 16 16 16 16 16 16 16 16 28 20 2 2 2 2 2 2 2 2 21 16 16 16 16 16 16 16 16 16 16 16 16 16 16 16 16 16 16 16 16 16 16 
2 2 2 2 2 2 2 2 94 95 96 78 1 1 101 100 18 19 29 15 16 16 16 16 16 16 16 16 16 16 16 16 16 16 16 16 22 91 92 93 78 82 83 84 85 94 95 96 38 82 83 101 100 86 87 90 18 29 16 16 16 16 16 16 16 16 16 16 28 20 2 2 2 2 2 2 18 29 16 16 16 16 16 16 16 16 16 16 16 16 16 16 16 16 16 16 16 16 16 16 
2 2 2 2 2 2 2 1 91 92 93 101 100 39 99 98 21 16 16 16 16 16 16 16 16 16 16 16 16 16 16 16 16 16 16 16 22 86 87 90 1 80 81 82 83 91 92 93 1 80 81 99 98 18 19 19 29 16 16 16 16 16 16 16 16 16 16 16 16 28 19 19 19 19 19 19 29 16 16 16 16 16 16 16 16 16 16 16 16 16 16 16 16 16 16 16 16 16 16 16 
2 2 2 2 2 2 32 1 86 87 90 99 98 1 18 19 29 16 16 16 16 16 16 16 16 16 16 16 16 16 16 16 16 16 16 16 28 20 1 1 38 1 78 80 81 86 87 90 38 1 1 18 19 29 16 16 16 16 16 16 16 16 16 16 16 16 16 16 16 16 16 16 16 16 16 16 16 16 16 16 16 16 16 16 16 16 16 16 16 16 16 16 16 16 16 16 16 16 16 16