18 18 18 18 18 18 18 18 18 18 18 18 18 18 18 18 18 18 18 18 18 18 18 18 18 18 18 18 18 18 18 18 18 18 18 18 18 18 18 18 18 18 18 18 18 18 18 18 18 18 
18 18 18 19 19 18 18 18 18 18 18 18 18 18 18 19 18 19 19 19 18 18 18 18 18 18 18 18 18 18 18 18 18 18 18 18 19 19 18 18 18 18 18 18 18 18 18 18 18 18 
18 18 18 18 18 18 18 18 18 18 18 19 19 18 18 18 18 18 18 18 18 18 19 18 18 18 18 18 18 18 18 18 18 18 18 18 18 19 19 18 18 18 18 18 18 19 19 19 18 18 
18 18 18 18 18 18 18 18 18 18 18 18 18 18 18 18 18 18 18 18 18 18 18 18 18 18 18 18 19 19 18 18 18 18 18 18 18 18 18 18 18 18 18 18 18 18 18 18 18 18 
18 18 18 18 29 27 27 27 27 27 27 27 27 27 27 27 27 27 27 27 27 27 27 27 27 27 27 27 27 27 27 27 27 27 27 27 27 27 27 27 27 27 27 27 27 30 18 18 18 18 
18 18 18 18 25 56 2 39 2 2 2 2 2 2 2 2 43 2 2 2 2 2 2 2 2 2 53 2 2 2 2 2 2 2 2 2 43 45 55 2 2 2 2 2 2 24 18 18 18 18 
18 18 18 18 25 2 2 2 2 2 2 43 2 2 2 2 54 41 2 2 2 2 2 2 2 2 2 2 2 2 2 2 2 2 2 2 2 39 50 2 39 2 2 2 2 24 18 19 19 19 
18 19 18 18 25 2 2 2 2 2 12 10 10 10 10 10 13 2 20 2 2 2 2 2 39 2 2 2 2 2 2 39 52 2 2 2 2 2 2 2 2 2 43 2 39 24 18 18 18 18 
18 18 18 18 25 2 2 2 1 1 8 3 3 3 3 3 7 2 2 2 2 2 2 2 2 2 2 43 2 2 2 2 2 2 2 2 2 2 2 2 20 2 40 50 2 24 18 18 18 18 
18 18 18 18 25 2 54 45 40 1 14 5 5 5 6 3 7 2 2 2 2 33 33 33 33 33 33 33 33 33 33 33 33 33 33 33 33 33 33 33 33 33 33 33 2 24 18 18 18 18 
18 18 18 18 25 2 39 39 53 2 2 2 2 2 8 3 7 2 2 2 2 33 3 3 3 3 3 3 3 3 3 3 3 3 3 3 3 3 3 3 3 3 3 33 2 24 18 18 18 18 
18 18 18 18 25 2 2 2 2 2 2 2 2 2 8 3 7 2 2 43 2 33 3 17 17 17 17 17 17 17 17 17 17 17 17 17 17 17 17 17 17 17 3 33 2 24 18 19 18 18 
18 18 18 18 25 2 2 2 39 2 2 2 49 55 8 3 7 2 2 2 2 33 3 17 17 17 17 17 17 17 17 17 17 17 17 17 17 17 17 17 17 17 3 33 54 24 18 18 18 18 
18 18 18 18 25 2 2 2 2 2 2 2 56 54 8 3 7 52 2 2 2 33 3 17 17 17 17 17 17 17 17 17 17 17 17 17 17 17 17 17 17 17 3 33 2 24 18 18 18 18 
18 18 18 18 25 2 2 2 43 45 40 2 2 2 8 3 7 2 2 2 2 33 3 17 17 17 17 17 17 17 17 17 17 17 17 17 17 17 17 17 17 17 3 33 2 24 18 18 18 18 
18 18 18 18 25 2 2 2 2 39 2 2 2 2 8 3 7 2 2 2 2 33 3 37 17 17 17 17 17 17 17 17 17 17 17 17 17 17 17 17 17 17 3 33 2 24 18 18 18 18 
18 18 18 19 25 2 2 2 2 2 2 2 2 2 8 3 7 43 2 2 2 33 3 3 3 3 3 3 3 3 3 3 3 3 3 3 3 3 3 3 3 3 3 33 2 24 18 18 18 19
18 18 18 18 25 2 2 2 2 2 2 2 2 2 8 3 7 16 55 2 2 33 33 33 33 33 33 33 33 33 33 33 33 33 33 3 3 3 33 33 33 33 33 33 2 24 18 18 18 18
18 18 19 18 25 43 51 2 2 2 2 2 2 2 8 3 9 10 10 10 10 10 10 10 10 10 10 10 10 10 10 10 10 10 11 3 3 3 7 34 2 2 43 2 2 24 18 18 18 18 
18 18 18 18 25 2 2 20 2 2 2 2 2 2 8 3 3 3 3 3 3 3 3 3 3 3 3 3 3 3 3 3 3 3 3 3 3 3 7 2 2 2 2 2 2 24 18 18 18 18 
18 18 18 18 25 2 2 2 2 2 2 2 2 2 14 5 5 5 5 5 5 5 5 5 5 5 5 5 5 5 5 5 5 5 5 5 5 5 15 2 2 2 2 2 2 24 18 19 18 18 
18 18 18 18 25 2 2 20 2 2 2 2 2 2 2 2 2 2 2 2 2 2 2 2 2 2 2 2 2 2 2 2 2 2 2 2 2 2 2 2 2 43 2 2 2 24 18 18 18 18 
18 18 18 18 25 2 2 2 2 2 2 2 2 49 40 2 2 2 2 2 2 2 39 2 2 2 2 2 2 2 2 2 2 2 2 2 2 2 2 43 2 2 50 2 2 24 18 18 18 18 
18 18 18 18 25 2 2 2 2 2 2 2 2 39 2 2 2 2 2 2 2 2 2 2 2 2 2 2 39 2 2 2 2 2 2 2 2 2 2 2 2 2 2 2 2 24 18 18 18 18 
18 18 18 18 25 2 2 2 2 2 2 2 2 2 2 2 20 2 2 2 2 2 2 2 2 2 2 2 2 2 2 2 39 2 2 2 2 2 2 2 2 2 2 2 2 24 18 18 18 18 
18 18 18 18 25 2 2 2 20 2 2 39 2 2 2 2 2 2 2 2 2 2 2 2 2 2 2 2 2 2 2 2 2 2 2 2 2 2 2 2 2 2 2 2 2 24 18 18 18 18 
18 18 18 18 25 2 2 2 2 21 22 22 23 2 2 2 2 2 2 2 2 49 41 55 39 2 2 2 2 2 43 55 2 2 2 2 2 43 51 2 2 39 2 2 2 24 18 19 18 18 
18 19 18 18 25 43 2 2 2 24 18 18 25 2 55 2 2 2 2 2 2 2 20 20 2 2 2 2 2 2 2 20 2 2 2 2 43 2 39 2 2 2 2 2 2 24 18 19 19 18 
18 18 19 18 25 2 2 2 2 24 18 19 25 2 20 2 2 2 2 2 2 2 2 2 2 2 2 2 2 2 2 2 2 2 2 2 2 2 43 2 43 43 43 2 2 24 18 18 19 19 
18 18 19 18 25 2 2 2 2 26 27 27 28 2 2 2 2 2 2 2 2 2 2 2 2 2 2 2 2 2 2 2 2 2 2 2 2 2 43 2 43 2 2 2 2 24 18 18 18 18 
18 18 18 18 25 2 2 2 2 2 2 2 2 2 2 2 20 2 2 2 2 20 2 2 2 2 2 20 2 2 2 2 2 2 2 2 2 2 43 43 43 43 43 2 2 24 18 18 18 18 
18 18 18 18 25 2 2 2 2 2 2 20 2 2 2 2 2 2 2 43 49 55 2 2 2 2 2 2 2 2 20 2 2 2 2 2 2 2 2 2 43 2 43 2 2 24 18 18 18 18 
18 18 18 18 25 2 2 2 2 2 2 54 2 2 2 2 2 2 2 43 39 2 2 2 2 2 2 2 2 2 2 2 2 2 39 2 2 2 43 43 43 2 43 2 2 24 18 18 18 18 
18 18 18 18 25 2 2 2 2 2 2 52 40 2 2 2 2 2 2 2 2 2 2 2 2 21 22 22 22 22 22 22 23 2 2 2 54 40 2 2 2 2 52 2 2 24 18 18 18 18 
18 18 18 18 25 2 2 2 2 43 2 39 2 2 2 43 2 2 2 2 21 22 22 22 22 32 18 18 18 18 18 19 25 2 2 2 2 53 2 2 2 2 39 2 2 24 18 18 18 18 
18 18 18 18 25 2 2 2 2 2 40 2 2 2 2 2 2 2 2 21 32 18 18 18 18 29 27 27 30 18 18 18 25 2 20 2 2 2 2 2 2 2 2 2 2 24 18 19 18 18 
18 18 18 18 25 2 2 2 20 2 2 2 2 2 2 2 2 2 2 24 18 18 18 18 18 25 43 51 24 18 18 18 31 22 23 2 2 2 2 2 2 20 2 2 2 24 18 18 18 18 
18 18 18 18 25 2 2 2 2 2 2 2 2 2 2 2 2 2 20 24 18 19 19 18 18 31 22 22 32 18 18 18 19 19 25 2 2 2 2 2 2 2 2 43 2 24 18 19 18 18 
18 18 18 18 25 2 2 2 2 2 20 2 2 2 2 40 2 2 2 24 18 18 18 18 18 18 19 18 18 18 18 18 18 18 25 2 2 2 2 2 20 2 2 51 1 24 18 19 18 18 
18 18 18 18 25 2 2 2 2 2 2 2 2 2 39 2 2 2 54 26 27 27 27 27 27 27 27 27 27 27 27 27 27 27 28 2 2 2 20 2 2 2 2 40 1 24 18 18 18 18 
18 18 18 19 25 2 2 43 46 2 2 2 2 2 2 2 2 2 2 2 2 2 2 20 2 2 2 2 2 43 40 2 2 2 2 2 2 2 2 43 46 55 2 2 2 24 18 18 18 18 
18 19 18 19 25 2 2 2 53 20 2 2 2 43 2 2 2 2 2 20 2 2 2 2 2 2 51 20 2 2 2 2 2 2 2 2 2 2 2 2 20 2 2 2 2 24 18 18 18 18 
18 18 18 18 25 2 2 2 2 2 2 20 2 52 2 2 2 2 2 2 2 2 2 2 2 2 2 2 2 2 2 2 2 2 2 2 2 2 2 2 2 20 2 2 2 24 18 18 19 18 
18 18 18 18 25 2 2 2 2 2 2 2 2 2 2 2 2 2 44 2 2 2 43 45 20 2 2 2 2 2 2 2 20 2 2 2 2 2 2 2 2 2 2 2 2 24 18 18 18 18 
18 18 18 18 25 39 53 2 2 2 2 2 2 2 2 2 2 2 2 2 2 2 2 39 53 2 2 2 2 2 2 2 2 2 2 2 39 52 40 2 2 2 2 2 2 24 18 18 18 18 
18 18 18 18 31 22 22 22 22 22 22 22 22 22 22 22 22 22 22 22 22 22 22 22 22 22 22 22 22 22 22 22 22 22 22 22 22 22 22 22 22 22 22 22 22 32 18 18 18 18 
18 18 18 18 18 18 18 18 18 18 18 18 18 18 18 18 18 18 18 18 18 18 18 18 18 18 18 18 18 18 18 18 18 18 18 18 18 18 18 18 18 18 18 18 18 18 18 18 18 18 
18 18 18 18 18 18 18 18 18 18 18 18 19 19 18 18 18 18 18 18 18 18 18 19 18 18 18 18 18 18 18 18 18 18 18 18 18 19 18 18 18 18 18 18 18 19 18 18 18 18 
18 18 18 18 19 19 18 18 18 18 18 18 18 18 19 18 18 18 18 18 18 18 18 18 18 18 18 18 19 19 19 19 18 18 18 18 18 18 18 18 18 18 18 18 18 18 18 18 18 18 
18 18 18 18 18 18 18 18 18 18 18 18 18 18 18 18 18 18 18 18 18 18 18 18 18 18 18 18 18 18 18 18 18 18 18 18 18 18 18 18 18 19 19 18 18 18 18 18 18 18 